21
...##....####.#......
.#............##...#.
##.S.#....#.....#....
....##.....###..#....
..###..#.....###.....
.....###.......##.##.
............#........
.###......##....#.#..
#..........##...#..##
#.##...#.....#....##.
..#....##....#.......
.........#...#.......
#..##.##.#####...G.#.
#.##.##..#....##.....
.#...#...#....##.....
.#....#......##....#.
..#...##......######.
..##...#......#.....#
.......#.....#..#...#
..#........###..##.#.
.....##.####.........
