10
S..##..#..
.#......##
##..##....
......#...
.##...#...
....#.....
..#.....#.
.##..#....
##.#...#..
...#.....G
