39
.......................................
.......................................
....................#######............
................###.....#######........
.............###....###...###..........
..........##......##.....####..........
............##.###........####.........
..............#............####........
............##...............####......
..........##.................####......
........##....................####.....
.......##..........#########...####....
......##.....######.....####...####....
.....##......#............##...........
....##.......#............##......###..
....#........#............##......###..
....##.......#...#######..##.......###.
.....#........#.....S.##..##........##.
.....#........#.......##..###......###.
......#.......#.......##..###.....###..
......#.......####....##...###....##...
.......#.........#######...###..###....
.......#...........####....###..##.....
.......##..................###.##......
.......###.................#####.......
.........#................######.......
..........##..........#########........
...........#.......##########..........
............#.##.###########...........
.............###.##.....###............
...........###.........###.............
........###...........##...............
.....###..............###..............
.....###............###...............#
......###.........###...............##.
.........###......####.............###.
............##########............##...
.................#################.....
......................................G
