48
S..#######..##########################...#######
#....#...........#...........#...........#......
#.##....#.#.#.###.#.#####.#.#.#.#.#.#.#.#.#.##..
#.#.....#...#...#.#.....#.#.....#.#.#.#.#.#...#.
#.#.###.#.#.#.#.#.#.##..#.#.#####.#.#.#.###.###.
#.#.#...#...#.#.#.#.#.#...#.#.....#.#.#...#.#...
#.#.#.#.#####.#.#.###.#.###.#.#.#.#.#.#.#.#.###.
#...#.#.......#.......#.....#.#.#.#.#.#.#.#.#.#.
###.#.#####.###.#.#.#.###.#.#.#.#.#.#.#.#.#.#.#.
#...#.......#...#.#.#...#.#.#.#...#.#.#.#.#.....
#.#########.#.#.###.#.#.#.#.###.#.#...#.#...#.#.
#.....#...#...#.....#.#.#.#...#.#.#...#.#.#.#.#.
###.#.#.#.#####.#.###.#.#.#.#.#.#.#.#.#.#.#.###.
#...#.#.#.....#.#...#.#.#.#.#.#...#...#.#.#.....
#.###.#####.#.#.###.#.#.#.#.#.#...#.#.#.#.#####.
#.#.......#.#.#...#.#.#.#.#.#.#.#.....#.#.#.....
#.#.#.#.###.#.#.#.#.#.#.#.#.#.#.#.#...#.#.#.#.#.
#.#.#.#...#.#.#.#.###...#.#.#.......#.#.#.#.#.#.
#.#.#.###.#.#.#.#.#....####.....#...#.....#.#.#.
#.#.#.....#.#.#.#.#.#.#.#.#.#.#.#.#.#.#.#.#.#.#.
#.#####.#.#.#.#.#.#.#.#.#.#.#.#.#.#.#.#.#.#.###.
#.....#.#.#.#.#.#.#.#.#.#.#.#.#.#.#.#.#.#.#.....
#.###.#.#.#.#.#.#.#.#.#.#.#...#.#.....#...#.#.#.
#.#...#.#.#.#.#.#.#.#.#.#.#.#.#.#.#.#.#.#.#.#.#.
#.#.#.#.#.#.#...#.#.#.#.#...#...#.#.#...#.#.#.#.
#.#.#.#.#.#.#...#.#.......#.#.#.#...#.#...#.#.#.
#.#.#.#.#.#.#.#...#.#.#...#.#.#.#.#.#.#.#...#.#.
#.#.#.#.#.#.#.#.#.#.#.#.#.#.#.#.#.#.#.#.#.#.#.#.
#.#.#.#.#.#.#.#.#..#.#.#.#.#....#.#.#.#.....#.#.
#.#.#.#.#.#.#.#.#.#.#.#.....#.#.#.#.#.#.#.#.....
#.#.#.#.#.#.#.#.#.#.#.#.#.#.#.#.#.#.#.#.#.#.#.#.
###.#.#####.###.#.#.#.###.#.#.#.#.#.#.#.#.#.#.#.
#...#.......#...#.#.#...#.#.#.#...#.#.#.#.#.....
#.#########.#.#.###.#.#.#.#.###.#.#...#.#...#.#.
#.....#...#...#.....#.#.#.#...#.#.#...#.#.#.#.#.
###.#.#.#.#####.#.###.#.#.#.#.#.#.#.#.#.#.#.###.
#...#.#.#.....#.#...#.#.#.#.#.#...#...#.#.#.....
#.###.#####.#.#.###.#.#.#.#.#.#...#.#.#.#.#####.
#.#.......#.#.#...#.#.#.#.#.#.#.#.....#.#.#.....
#.#.#.#.###.#.#.#.#.#.#.#.#.#.#.#.#...#.#.#.#.#.
#.#.#.#...#.#.#.#.###...#.#.#.......#.#.#.#.#.#.
#.#.#.###.#.#.#.#.#....####.....#...#.....#.#.#.
#.#.#.....#.#.#.#.#.#.#.#.#.#.#.#.#.#.#.#.#.#.#.
#.#####.#.#.#.#.#.#.#.#.#.#.#.#.#.#.#.#.#.#.###.
#.....#.#.#.#.#.#.#.#.#.#.#.#.#.#.#.#.#.#.#.....
#.###.#.#.#.#.#.#.#.#.#.#.#...#.#.....#...#.#.#.
#.#...#.#.#.#.#.#.#.#.#.#.#.#.#.#.#.#.#.#.#.#.#.
#.#.#.#.#.#.#...#.#.......#.#.#.#...#.#........G